+-------------+
|S*********** |
|   *       * |
|  **  ***  * |
|   **      * |
| ***       F |
+-------------+
